xdxxxxxxxxxxx
x  c        x
xmxx xxx xxmx
xcx   c   x x
x x xxxxx x x
x c xd e  x x
x x     x   x
x x xxxxx x x
x x c     xcx
x xxx x xxd x
x    c      x
xxxxxxxxxxxxx
